11111111111111
1E000000000001
10100101T01001
1010010J101011
1P0000000C0011
11111111111111
