0000000000000
10P00000C00C1
1000000000001
1000000000001
1000000E00001
1000000000001
1000000000001
1000000000001
1111111111111
