1111111111111111111111111
10P00000C00C1111111111111
1000000000001
1000000000001
1000000E00001
1000000000001
1000000000001
1000000000001
1111111111111
