11111111111111
1E000000000001
10100101001001
1010010M101011
1P0000000C0011
11111111111111
