1111111111111
10P00000C00E1
1000000000001
1000000000001
10000000M0001
1000000000001
10000000M0001
10000M0000001
1111111111111
