1111111111111
10P0000000CE1
1111111111111