1111111111111
10P0000000E01
1000000000001
10000C0000001
100000C000001
1000000CC0001
100000000C001
1111111111111