1111111111111
10P00000C00C1
1000000000001
1000000000001
1000000E00001
10000M0000001
1000000000001
1000000000001
1111111111111
