1111111111111
10P0000000001
1000000000001
1000000000001
1000000000011
1000000000001
1000000000001
1111111111111