1111111111111
10p0000000001
1000000000001
1111111111111
