1111111111111
10P00000C00C1
1000000000001
1C0000MMM0001
100000MEM0001
100000M0M0001
1C00000000001
100M00C0C0001
1111111111111
