11111111111111
1E000000000001
10100101001001
10100100101011
1P0000000C0011
11111111111111
